%%%%%%%%%%%%%%%
%             %
%             %
%  o%%%%o%o   %
%   %.   %    %
%  o%%%  o    %
%    % G %    %
%   %%  %%%o  %
%  o%         %
%   %%%%%%    %
%             %
%P%%%%%%%%%%%%%
