%%%%%%
%   o%
%  o.%
%   G%
%    %
%P%%%%
