%%%%%%
%   G%
%  o.%
%   o%
%    %
%P%%%%
