%%%%%%%%%
%   %   %
%  o.o  %
%    %  %
%  o%o  %
% G     %
%P%%%%%%%
